000 000 000 000 000 011 012 026 027 019 020 021 022 023 024 025 011 012 013 014 015 016 017 018 018 019 020 021 022 023 024 025 000 000 000 000 000 000 000 000 000 000 000 000 000 000 000
000 000 000 000 000 011 033 029 029 029 029 029 029 029 030 025 011 028 044 044 044 029 029 102 102 102 037 102 102 102 030 025 000 000 000 000 000 000 000 000 000 000 000 000 000 000 000
000 000 000 000 000 011 033 029 029 029 029 029 029 029 034 035 032 033 044 029 036 029 029 102 102 102 102 102 037 102 034 035 000 000 000 000 000 000 000 000 000 000 000 000 000 000 000
000 000 000 000 000 011 033 029 029 044 044 044 029 029 040 041 042 043 029 029 029 029 029 102 102 102 102 029 029 102 052 025 000 000 000 000 000 000 000 000 000 000 000 000 000 000 000
000 000 000 000 000 011 033 029 029 044 044 029 029 029 098 049 050 099 029 029 029 029 029 102 102 102 102 029 029 029 052 025 000 000 000 000 000 000 000 000 000 000 000 000 000 000 000
000 000 000 000 000 011 033 029 029 044 029 029 029 029 055 056 057 058 029 029 029 029 029 102 102 102 102 029 029 102 052 025 000 000 000 000 000 000 000 000 000 000 000 000 000 000 000
000 000 000 000 000 011 033 029 029 029 029 029 029 029 063 064 061 062 044 029 036 029 029 102 102 102 102 102 037 102 063 064 000 000 000 000 000 000 000 000 000 000 000 000 000 000 000
000 000 000 000 000 011 033 029 029 029 029 029 029 029 059 025 011 054 044 044 044 029 029 029 029 102 037 102 102 102 059 025 000 000 000 000 000 000 000 000 000 000 000 000 000 000 000
000 000 000 000 000 011 067 112 113 074 075 076 077 078 079 025 011 067 068 069 070 071 072 112 113 074 075 076 077 078 079 025 000 000 000 000 000 000 000 000 000 000 000 000 000 000 000
000 000 000 000 000 082 086 091 091 087 088 083 083 089 083 090 082 083 084 083 083 085 086 091 091 087 088 083 083 089 083 090 000 000 000 000 000 000 000 000 000 000 000 000 000 000 000
001 002 003 002 002 004 005 010 010 006 007 002 002 008 002 009 001 002 003 002 002 004 005 010 010 006 007 002 002 008 002 009 001 002 003 002 002 004 002 002 002 002 007 002 002 008 002
011 012 013 014 015 016 017 128 129 019 020 021 022 023 024 025 011 012 013 014 015 016 017 128 129 019 020 021 022 023 024 025 011 012 013 014 015 016 017 018 019 019 020 021 022 023 024
011 028 029 029 029 044 044 029 029 044 029 029 029 029 030 025 011 028 029 029 029 029 029 029 029 029 029 029 029 029 030 025 011 028 044 044 044 044 029 029 029 029 044 044 044 044 030
032 033 029 029 029 029 044 029 029 029 029 029 029 029 034 035 032 033 029 029 029 029 029 029 029 029 029 029 029 029 034 035 032 033 044 044 044 029 029 029 029 029 029 044 044 044 034
011 039 029 029 029 029 029 029 029 029 029 029 029 029 040 041 042 043 029 029 029 029 029 029 029 029 029 029 029 029 052 025 011 047 044 029 029 029 029 029 029 029 029 029 029 044 030
011 047 029 029 044 029 029 029 029 029 029 029 029 029 098 049 050 099 029 029 029 029 029 029 029 029 029 029 029 029 052 025 011 047 029 029 029 029 029 029 029 029 029 029 029 029 059
011 054 029 029 044 044 029 029 029 029 029 029 102 102 055 056 057 058 029 029 029 029 029 029 029 029 029 029 029 029 063 025 011 047 044 029 029 029 029 029 029 029 029 029 029 044 052
061 062 029 029 029 029 029 029 029 029 029 102 102 102 063 064 061 062 029 029 029 029 029 029 029 029 029 029 029 029 063 064 061 062 044 044 044 029 029 029 029 029 029 044 044 044 063
011 054 029 029 029 029 029 029 029 029 029 102 102 029 059 025 011 054 029 029 029 029 029 029 029 029 029 029 029 029 059 025 011 054 044 044 044 044 029 029 029 029 044 044 044 044 059
011 067 068 069 070 071 072 068 078 074 075 076 077 078 079 025 011 067 068 069 070 071 072 092 093 074 075 076 077 078 079 025 011 067 068 069 070 071 072 092 093 074 075 076 077 078 079
082 083 084 083 083 085 083 084 089 083 088 083 083 089 083 090 082 083 084 083 083 085 086 091 091 087 088 083 083 089 083 090 082 083 084 083 083 085 086 091 091 087 088 083 083 089 083
001 002 003 002 002 004 002 002 002 002 007 002 002 008 002 009 001 002 003 002 002 004 005 010 010 006 007 002 002 008 002 009 001 002 003 002 002 004 005 010 010 006 007 002 002 008 002
011 012 013 014 015 016 017 017 019 019 020 021 022 023 024 025 011 012 013 014 015 016 017 026 027 019 020 021 022 023 024 025 011 012 013 014 015 016 017 160 161 019 020 021 022 023 024
011 028 102 102 102 102 044 044 044 044 029 029 029 029 030 025 011 028 102 102 102 044 044 029 029 044 044 102 102 102 030 025 011 028 029 029 029 029 029 029 029 029 029 029 029 029 030
032 033 102 102 102 102 102 044 044 044 029 029 029 029 034 035 032 033 102 102 102 102 044 029 029 044 102 102 102 102 034 035 032 033 029 029 029 029 029 029 029 029 029 029 029 029 034
011 039 102 102 102 102 102 102 044 044 029 029 029 037 040 041 042 043 102 029 102 102 104 029 029 103 102 102 029 102 040 041 042 043 029 029 029 029 029 029 029 029 029 029 029 029 052
011 047 102 102 102 102 102 102 029 044 029 029 029 029 048 049 050 051 029 029 029 029 029 029 029 029 029 029 029 029 098 049 050 099 029 029 029 029 029 029 029 029 029 029 029 029 059
011 054 102 102 102 102 102 102 044 044 029 029 029 037 055 056 057 058 102 102 102 029 102 029 029 102 029 102 102 102 055 056 057 058 029 029 029 029 029 029 029 029 029 029 029 029 059
061 062 102 102 102 102 102 102 102 102 029 029 029 029 063 064 061 062 102 102 102 102 102 029 029 102 102 102 102 102 063 064 061 062 029 029 029 029 029 029 029 029 029 029 029 029 063
011 054 102 102 102 102 102 102 102 102 029 029 029 029 059 025 011 054 102 102 102 102 102 029 029 102 102 102 102 102 059 025 011 054 029 029 029 029 029 029 029 029 029 029 029 029 059
011 067 068 069 070 071 072 068 078 074 075 076 077 078 079 025 011 067 068 069 070 071 072 092 093 074 075 076 077 078 079 025 011 067 068 069 070 071 072 068 078 074 075 076 077 078 079
082 083 084 083 083 085 083 084 089 083 088 083 083 089 083 090 082 083 084 083 083 085 086 091 091 087 088 083 083 089 083 090 082 083 084 083 083 085 083 084 089 083 088 083 083 089 083
000 000 000 000 000 000 000 000 000 000 000 000 000 000 000 000 001 002 003 002 002 004 005 010 010 006 007 002 002 008 002 009 000 000 000 000 000 000 000 000 000 000 000 000 000 000 000
000 000 000 000 000 000 000 000 000 000 000 000 000 000 000 000 011 012 013 014 015 016 017 026 027 019 020 021 022 023 024 025 000 000 000 000 000 000 000 000 000 000 000 000 000 000 000
000 000 000 000 000 000 000 000 000 000 000 000 000 000 000 000 011 028 044 044 029 029 029 029 029 102 102 102 102 102 030 025 000 000 000 000 000 000 000 000 000 000 000 000 000 000 000
000 000 000 000 000 000 000 000 000 000 000 000 000 000 000 000 032 033 044 029 029 029 102 102 102 102 102 102 102 102 034 035 000 000 000 000 000 000 000 000 000 000 000 000 000 000 000
000 000 000 000 000 000 000 000 000 000 000 000 000 000 000 000 011 047 029 029 029 029 102 102 102 102 102 102 102 102 052 025 000 000 000 000 000 000 000 000 000 000 000 000 000 000 000
000 000 000 000 000 000 000 000 000 000 000 000 000 000 000 000 011 047 029 029 029 029 102 102 102 029 102 102 102 029 052 025 000 000 000 000 000 000 000 000 000 000 000 000 000 000 000
000 000 000 000 000 000 000 000 000 000 000 000 000 000 000 000 011 047 029 029 029 029 102 102 102 102 102 102 102 102 052 025 000 000 000 000 000 000 000 000 000 000 000 000 000 000 000
000 000 000 000 000 000 000 000 000 000 000 000 000 000 000 000 061 062 044 029 029 029 102 102 102 102 102 102 102 102 063 064 000 000 000 000 000 000 000 000 000 000 000 000 000 000 000
000 000 000 000 000 000 000 000 000 000 000 000 000 000 000 000 011 054 044 044 029 029 029 029 029 102 102 102 102 102 059 025 000 000 000 000 000 000 000 000 000 000 000 000 000 000 000
000 000 000 000 000 000 000 000 000 000 000 000 000 000 000 000 011 067 068 069 070 071 072 073 073 074 075 076 077 078 079 025 000 000 000 000 000 000 000 000 000 000 000 000 000 000 000
000 000 000 000 000 000 000 000 000 000 000 000 000 000 000 000 082 083 084 083 083 085 083 083 083 083 088 083 083 089 083 090 000 000 000 000 000 000 000 000 000 000 000 000 000 000 000